8 8
0000000E
00000000
01110000
00000000
11101111
S0000000
00000000
00000000
